NO          texture/2.xpm


      SO texture/1.xpm      
   WE    texture/3.xpm
EA texture/6.xpm




F 2,      22,255
C 225,30,0

11011111
1S101111         
101D1001
10000001
11111111