NO texture/1.xpm 
SO texture/2.xpm 
WE texture/3.xpm 
EA texture/6.xpm 




F 2,22,255
C 225,30,0

11111111
100001111
100E11
111111