NO texture/1.xpm


SO texture/2.xpm
WE texture/3.xpm
EA texture/6.xpm




F 2,22,255
C 225,30,123
1
011       11
11       101 
111111111011
  1010111011        
 1 10000E0011
 111110111111
 111111111111