NO texture/1.xpm 
SO texture/2.xpm 
WE texture/3.xpm 
EA texture/6.xpm 




F 2,22,1
C 225,30,250
                                1111
                                1 11
                                1111
        11111111111111111111111111
        11111111111111111111111111
        11111111111111111111111111           1111111                        11  11 
        1S0001  10110000000000001            1001                           11 11
        101101  11110000111000001            1111111  11   11   1111111     1111
        10010011100000001 1000001            11       11   11   11          1111
111111111011000001110000111000001           111       11   11   11          11 11
100000000011000001110111111111111          1111       1111111   1111111     11  11
11110111111111011100000010001             1
11110111111111011101010010001          111          1111111111   111    111
11000000110101111100000010001          101          1110000111     11  11
10000000000000001100000010001          111             1001          11
10000000000000001101010010001         11               1001          11
11000001110101011111011110101        111111111         1001          11                           
11110111 1110101 101111011101        101               1001          11
11111111 1111111 111111111111        111               1111          11111111111111111111111111111