11111111111111111111111111
11N                      1
111                      1
111       101            11
111        1             1
111                      111
11111111111111111111111111