 11111111
111111111
1  E11
111111